000000000000000000
001010101010101000
011030002030200010
011030002030200010
011000002030200010
011010101010001010
011111111111111110
000000000000000000
022200000000000000
000000000000000000
033300000000000010
000001000000103330
000001001000010010
010000020200000010
010000020200000010
010000020300000010
000000000000000000
000000000000000000